C 255,255,255

NO ./textures/north.xpm
WE ./textures/west.xpm
SO ./textures/south.xpm
EA ./textures/east.xpm

F 50,50,50

11111111111111111111111111111111111111111111111111111
10000000000000000000000000000000000000000000000000001
10010000000001111111111111111111111111111111111111001
10000000000001                                   1001
10000000100001                                   1001
10000E00100001                                   1001
10000000000001                                   1001
11111111111111                                   1001
                                              1111001111
                                              1000000001
                                              1000000001
                                              1111111111